07 07 07 07 07 07 07 07 07 07 07 07
07 07 07 07 07 07 07 07 07 07 07 07
07 07 07 07 07 07 07 07 07 07 07 07
07 07 07 07 07 07 07 07 07 07 07 07
07 07 07 07 07 07 07 07 07 07 07 07
01 01 01 01 01 04 02 02 02 02 02 06
00 00 00 00 00 03 02 02 02 02 02 05
00 00 00 00 00 03 02 02 02 02 02 05
